ABK = Abkhazia - Fully changed - Allego
AFG = Afghanistan - Fully changed - Allego
AIN = Ainu - Fully changed - Allego
ALB = Albania - Not changed
ALG = Algeria - Not changed
AND = Andorra - Not changed
ANG = Angola - Not changed
BAS = Antigua and Barbuda - Not changed
ARG = Argentina - Not changed
ARM = Armenia - Not changed
AST = Australia - Not changed
AUS = Austria - Not changed
AZR = Azerbaijan - Not changed
BEL = Belgium - Not changed
DAH = Benin - Not changed
BHU = Bhutan - Not changed
BOL = Bolivia - Not changed
VOL = Upper Volta - Not changed
BLR = Belarus - Not changed
BAN = Bangladesh - Not changed
BRB = Barbados - Not changed
BRI = Brittany - Not changed
BRU = Brunei - Not changed
BLZ = Belize - Not changed
BOS = Bosnia - Not changed
BOT = Botswana - Not changed
BAH = Bahamas - Not changed
BRD = Burundi - Not changed
BAR = Bahrain - Not changed
BRA = Brazil - Starting leader changed - Allego
BUL = Bulgaria - Not changed
CAB = Cabo Verde - Not changed
CAR = Central African Republic - Not changed
CMR = Cameroon - Not changed
CAN = Canada - Not changed
CAY = Cayenne - Not changed
RCG = Republic of Congo - Not changed
CRC = Curacao - Not changed
CRO = Croatia - Not changed
CHA = Chad - Not changed
CUB = Cuba - Not changed
CHE = Chechnya - Not changed
CHI = China - Not changed
CHL = Chile - Not changed
CAM = Cambodia - Not changed
CAT = Catalonia - Not changed
COM = Comoros - Not changed
COL = Colombia - Not changed
COS = Costa Rica - Not changed
CYP = Cyprus - Not changed
CZE = Czechoslovakia - Not changed
CSA = CSA - Not changed
COR = Corsica - Not changed
DEN = Denmark - Starting leader changed - Allego
DDR = East Germany - Not changed
WGR = West Germany - Not changed
COG = Congo - Not changed
DJI = Djibouti - Not changed
DOM = Dominican Republic - Not changed
DMN = Dominica - Not changed
ECU = Ecuador - Not changed
EST = Estonia - Not changed
ENG = United Kingdom - Starting leader changed - Allego
ETI = East Timor - Not changed
EGY = Egypt - Not changed
ERI = Eritrea - Not changed
EQG = Equatorial Guinea - Not changed
ELS = El Salvador - Not changed
ETH = Ethiopia - Starting leader changed - Allego
FIN = Finland - Starting leader changed - Allego
FIJ = Fiji - Not changed
FAI = FaroeIslands - Not changed
FRA = France - Starting leader changed - Allego
GER = Germany - All leaders + important admirals and generals changed - Allego
GUA = Guatemla - Not changed
GAB = Gabon - Not changed
GAM = The Gambia - Not changed
GEO = Georgia - Not changed
GDL = Guadeloupe - Not changed
GHA = Ghana - Not changed
GNA = Guinea - Not changed
GYA = Guyana - Not changed
GNB = Guinea-Bissau - Not changed
GND = Grenada - Not changed
GRN = Greenland - Not changed
GRE = Greece - Not changed
GXC = Guangxi - Not changed
HON = Honduras - Not changed
HAI = Haiti - Not changed
HLS = HolySee - Not changed
HKN = HongKong - Fully changed - Allego
HUN = Hungary - Not changed
HOL = Holland - Not changed
IRE = Ireland - Not changed
IRQ = Iraq - Not changed
ISR = Israel - Starting leader changed - Allego
IVO = Ivory Coast - Not changed
ISS = Islamic State - Not changed
ICE = Iceland - Starting leader changed - Allego
ITA = Italy - Starting leader changed - Allego
INS = Indonesia - Not changed
JAP = Japan - Starting leader changed - Allego
JOR = Jordan - Not changed
JAM = Jamaica - Not changed
KOR = Korea - Not changed
KUW = Kuwait - Not changed
KUR = Kurdistan - Not changed
KIR = Kiribati - Not changed
KAZ = Kazakhstan - Not changed
KYR = Kyrgystan - Not changed
KEN = Kenya - Not changed
KOS = Kosovo - Not changed
LAT = Latvia - Not changed
LIB = Liberia - Not changed
LIT = Lithuania - Not changed
LAO = Laos - Not changed
LIC = Lichenstein - Not changed
LES = Lesotho - Not changed
LEB = Lebanon - Not changed
LUX = Luxemburg - Not changed
LBA = Libya - Not changed
MEX = Mexico - Not changed
HRZ = Herzegovina - Not changed
MAC = Macedonia - Not changed
MAD = Madagascar - Not changed
MRT = Mauritania - Not changed
MLI = Mali - Not changed
MAN = Manchukou - Not changed
MAU = Mauritius - Not changed
MOL = Moldova - Not changed
MEN = Mengkukuo - Not changed
MLT = Malta - Not changed
MLW = Malawi - Not changed
MAL = Malaysia - Not changed
BRM = Burma - Not changed
MOR = Morocco - Not changed
MCU = Macau - Fully changed - Allego
MOC = Monaco - Not changed
MLD = Maldives - Not changed
MAR = MarshallIslands - Not changed
MNT = Montenegro - Not changed
MON = Mongolia - Not changed
MZB = Mozambique - Not changed
NEP = Nepal - Not changed
NOR = Norway - Starting leader changed - Allego
NIC = Nicaragua - Not changed
NZL = New Zealand - Not changed
NGK = Nagorno-Karabakh - Not changed
NAU = Nauru - Not changed
NOV = Novorossiya - Not changed
NCY = Northern Cyprus - Not changed
NMB = Namibia - Not changed
NGR = Niger - Not changed
NGA = Nigeria - Not changed
NIR = Northern Ireland - Not changed
OCC = Occitania - Not changed
OMA = Oman - Not changed
PAN = Panama - Not changed
PER = Persia - Not changed
POR = Portugal - Not changed
PLU = Palau - Not changed
PAK = Pakistan - Not changed
PAL = Palestine - Not changed
PRK = Korea DPR - Leaders changed - Allego
PHI = Philippines - Not changed
PRC = ComChina - fully changed - Allego
PRU = Peru - Not changed
POL = Poland - Not changed
PAR = Paraguay - Not changed
PNG = Papua - Not changed
PUE = Puerto Rico - Not changed
QAT = Qatar - Not changed
QUE = Quebec - Not changed
RAJ = India - Starting leader changed - Allego
ROM = Romania - Not changed
RWA = Rwanda - Not changed
SER = Serbia - Not changed
SWI = Switzerland - Starting leader changed - Allego
SAF = South Africa - Not changed
SBR = SouthBrazil - Not changed
SAU = Saudi Arabia - Not changed
SLV = Slovenia - Not changed
SOM = Somalia - Not changed
SOS = South Ossetia - Not changed
SML = Somaliland - Not changed
SSD = South Sudan - Not changed
STL = St Lucia - Not changed
STV = St Vincent - Not changed
SUD = Sudan - Not changed
SCO = Scotland - Not changed
SYR = Syria - Starting leader changed - Allego
SLO = Slovakia - Not changed
SUR = Suriname - Not changed
SWZ = Swaziland - Not changed
SIG = Singapore - Not changed
SOL = Solomon Islands - Not changed
SIA = Thailand - Starting leader changed - Allego
SAO = Sao Tome and Principe - Not changed
SEN = Senegal - Not changed
SEY = Seychelles - Not changed
SRL = Sri Lanka - Not changed
SIE = Sierra Leone - Not changed
SPR = Spain - Starting leader changed - Allego
SOV = Russia - Starting leader changed - Allego
SWE = Sweden - Starting leader changed - Allego
SAN = San Marino - Not changed
SAM = Samoa - Not changed
SIK = Sinkiang - Not changed
TAN = Tannu Tuva - Not changed
TRI = Trinidad and Tobago - Not changed
TEX = Texas - Not changed
TIB = Tibet - Not changed
TAJ = Tajikistan - Not changed
TZN = Tanzania - Not changed
TOG = Togo - Not changed
TON = Tonga - Not changed
TRA = Transnistria - Fully changed - Allego
TMS = Turkmenistan - Not changed
TUN = Tunisia - Not changed
TUR = Turkey - Starting leader changed - Allego
TUV = Tuvalu - Not changed
URG = Uruguay - Not changed
UAE = United Arab Emirates - Not changed
UGA = Uganda - Not changed
UKR = Ukraine - Starting leader + Admirals changed - Allego
USA = USA - Starting leader + important generals changed - Allego
UZB = Uzbekistan - Not changed
VAN = Vanuatu - Not changed
VEN = Venezula - Not changed
VIN = Vietnam - Not changed
WLS = Wales - Not changed
WES = Western Sahara - Not changed
YEM = Yeman - Not changed
YUG = Yugoslavia - Not changed
ZAM = Zambia - Not changed
ZIM = Zimbabwe - Not changed
SHX = Shanxi - Not changed
USB = USB - Not changed
XSM = Xibei San Ma - Not changed
YUN = Yunnan - Not changed
BAY = Bavaria - Not changed
BSQ = Basques - Not changed
CAL = California - Not changed
FLN = Flanders - Not changed
WLN = Wallonia - Not changed
LOM = Lombardy - Not changed
VNT = Veneto - Not changed
NEG = New England - Not changed
ADU = Andalusia - Not changed
FSM = Micronesia - Not changed
GLC = Galicia - Not changed
GUM = Guam - Not changed
RYU = Ryukyu - Not changed
HAN = Hanover - Not changed
HAW = Hawaii - Not changed
MEK = Mecklenburg - Not changed
NAV = Navarra - Not changed
PRE = Prussia - Not changed
SAX = Saxony - Not changed
SHL = Schleswig-Holstein - Not changed
TAH = Tahiti - Not changed
WUR = Wurtemberg - Not changed
ZZZ = Anarchists - Not changed

Africa - fully changed - Allego
Arabia - fully changed - Allego
Asia - Not changed
Europe - Partly changed - Wolfxe (no more is used ingame however)
South America - Partly changed - Wolfxe